destWidth 128
destHeight 192
map_width 20
map_height 20
tile_width 32
tile_height 32
solid_tiles
6, 7, 8, 9, 10, 11, 12, 13, 14, 15, 16, 17, 18, 19, 20
layer1
0, 0, 0, 0, 0, 0, 0, 0, 0, 0, 0, 0, 0, 0, 0, 0, 0, 0, 0, 0
0, 0, 0, 0, 0, 0, 0, 0, 0, 0, 0, 0, 0, 0, 0, 0, 0, 0, 0, 0
0, 0, 5, 5, 5, 0, 0, 0, 0, 0, 0, 0, 0, 0, 0, 0, 0, 0, 0, 0
0, 0, 5, 5, 5, 3, 3, 3, 3, 3, 3, 3, 3, 3, 3, 3, 3, 3, 3, 23
0, 5, 5, 5, 5, 4, 4, 4, 4, 4, 4, 4, 4, 4, 4, 4, 4, 4, 4, 24
0, 0, 5, 5, 5, 0, 0, 0, 0, 0, 0, 0, 0, 0, 0, 0, 1, 2, 0, 0
0, 0, 5, 5, 5, 3, 3, 3, 3, 3, 3, 3, 3, 5, 0, 0, 1, 2, 0, 0
0, 5, 5, 5, 5, 4, 4, 4, 4, 4, 4, 4, 4, 5, 0, 0, 1, 2, 0, 0
0, 0, 5, 5, 5, 0, 0, 0, 0, 0, 0, 0, 0, 5, 0, 0, 1, 2, 0, 0
0, 0, 0, 0, 0, 0, 0, 0, 0, 0, 0, 0, 0, 0, 0, 0, 1, 2, 0, 0
0, 0, 0, 0, 0, 0, 0, 0, 0, 0, 0, 0, 0, 0, 0, 0, 1, 2, 0, 0
0, 5, 5, 5, 5, 5, 5, 0, 0, 0, 0, 0, 0, 0, 0, 0, 5, 5, 5, 0
0, 0, 5, 5, 0, 5, 5, 0, 0, 0, 0, 0, 0, 0, 0, 0, 5, 5, 5, 0
0, 5, 5, 5, 0, 5, 5, 5, 5, 0, 0, 0, 0, 5, 5, 5, 5, 5, 5, 0
0, 0, 5, 5, 0, 5, 5, 5, 5, 3, 3, 3, 3, 5, 5, 5, 5, 5, 5, 0
0, 0, 5, 5, 5, 5, 5, 5, 5, 4, 4, 4, 4, 5, 5, 5, 5, 5, 5, 0
0, 5, 5, 5, 5, 5, 5, 5, 5, 0, 0, 0, 0, 0, 0, 0, 0, 5, 5, 0
0, 5, 5, 5, 5, 5, 5, 5, 5, 0, 5, 5, 5, 5, 5, 5, 5, 5, 5, 0
0, 1, 2, 0, 0, 0, 0, 0, 0, 0, 5, 5, 5, 5, 5, 5, 5, 5, 5, 0
0, 1, 2, 0, 0, 0, 0, 0, 0, 0, 0, 0, 0, 0, 0, 0, 0, 0, 0, 0
layer2
21, 5, 5, 21, 5, 5, 5, 21, 5, 5, 21, 5, 5, 21, 5, 21, 5, 5, 5, 21
19, 19, 19, 19, 19, 19, 19, 19, 19, 19, 19, 19, 19, 19, 19, 19, 19, 19, 19, 19
18, 6, 0, 0, 0, 17, 18, 17, 17, 17, 18, 17, 17, 17, 17, 17, 18, 18, 17, 17
17, 7, 0, 0, 0, 0, 0, 0, 0, 0, 0, 0, 0, 0, 0, 0, 0, 0, 0, 0
17, 0, 0, 0, 0, 0, 0, 0, 0, 0, 0, 0, 0, 0, 0, 0, 0, 0, 0, 0
18, 8, 0, 0, 0, 18, 17, 17, 17, 17, 17, 17, 18, 17, 17, 17, 0, 0, 17, 18
17, 9, 0, 0, 0, 0, 0, 0, 0, 0, 0, 0, 0, 0, 8, 17, 0, 0, 17, 18
17, 0, 0, 0, 0, 0, 0, 0, 0, 0, 0, 0, 0, 0, 9, 17, 0, 0, 17, 17
17, 10, 0, 0, 0, 17, 17, 17, 17, 17, 17, 17, 17, 0, 10, 17, 0, 0, 17, 17
17, 14, 14, 14, 14, 14, 13, 13, 13, 14, 14, 14, 14, 17, 17, 18, 0, 0, 13, 13
17, 16, 15, 16, 16, 16, 15, 13, 13, 14, 14, 14, 14, 17, 17, 18, 0, 0, 15, 16
18, 0, 0, 0, 0, 0, 0, 13, 13, 14, 14, 14, 14, 13, 13, 13, 0, 0, 0, 17
18, 8, 0, 0, 9, 0, 0, 15, 16, 14, 14, 14, 14, 16, 15, 16, 0, 0, 0, 17
17, 0, 0, 0, 10, 0, 0, 0, 0, 16, 15, 16, 16, 0, 0, 0, 0, 0, 0, 17
17, 7, 0, 0, 11, 0, 0, 0, 0, 0, 0, 0, 0, 0, 0, 0, 0, 0, 0, 17
17, 6, 0, 0, 0, 0, 0, 0, 0, 0, 0, 0, 0, 0, 0, 0, 0, 0, 0, 17
17, 0, 0, 0, 0, 0, 0, 0, 0, 17, 17, 17, 17, 6, 7, 8, 9, 0, 0, 17
17, 0, 0, 0, 0, 0, 0, 0, 0, 17, 0, 0, 0, 0, 0, 0, 0, 0, 0, 17
17, 0, 0, 17, 17, 17, 18, 17, 17, 17, 0, 0, 0, 0, 0, 0, 0, 0, 0, 18
18, 0, 0, 17, 18, 17, 17, 17, 17, 17, 18, 18, 18, 17, 17, 17, 18, 17, 17, 17
